NO src/textures/eagle.xpm
SO src/textures/greystone.xpm
WE src/textures/purplestone.xpm
EA src/textures/red.xpm
C 0, 0, 0
F 25, 25, 255

11111111111111111111111111111111111111111111111111111111111111111111111111111
11111111100000000000000001111000000000000000000000000000000000000000000000001
10000000000000000011100010000000000000000000000000000000000000000000000000001
110000100000000000000000000000000000000000000000000000000000000000000000000S1
10000000000000000000000000000000000000000000000000000000000000000000000000001
10000000000000000000000000000000000000000000000000000000000000000000000000001
11111111111111111111111111111111111111111111111111111111111111111111111111111

