F 255,255,0
NO src/textures/eagle.xpm
SO src/textures/greystone.xpm
WE src/textures/purplestone.xpm
C 255,0,0
EA src/textures/red.xpm

        1111111111111111111111111
        1000000000110000000000001
        1011000001110000000000001
        1001000000000000010000001
111111111011000001110000000000001
100000000011000001110111001111111
11110111111111011100000010001
1111011111111101110101010001
1100000011010100000000010001
100000000000000000S10000001
1000000000010001101000000011
11000001110101011111011110001
11110111 1110101 10111101001
11111111 1111111 1111 1111111
