NO src/textures/eagle.xpm
SO src/textures/greystone.xpm
WE src/textures/purplestone.xpm
EA src/textures/red.xpm
C 255,255,0
F 255,255,0
11111111111111111111111
11000000000000000000011
11000000000000000000011
11000000000000000000011
11000000000000000000011
11000000000000000000011
11000000000000000000011
11000000000000000000011
11000000000000000000011
11000000000000000000011
11000000000000000000011
11000000000000000000011
11000000000000000000011
11000000000000000000011
11000000000000000000011
11000000000000000000011
11000000000000000000011
11000000000000000000011
11000000000000000000011
11000000000000000000011
11000000000000000000011
11000000000N00000000011
11111111111111111111111
